"filename", "language", "JavaScript", "CSS", "Markdown", "JSON", "HTML", "comment", "blank", "total"
"c:\Users\mrtan\Desktop\Code\html\software-engineer\scholarship-wepapp\client\README.md", "Markdown", 0, 0, 38, 0, 0, 0, 33, 71
"c:\Users\mrtan\Desktop\Code\html\software-engineer\scholarship-wepapp\client\README.old.md", "Markdown", 0, 0, 1, 0, 0, 0, 2, 3
"c:\Users\mrtan\Desktop\Code\html\software-engineer\scholarship-wepapp\client\package-lock.json", "JSON", 0, 0, 0, 29140, 0, 0, 1, 29141
"c:\Users\mrtan\Desktop\Code\html\software-engineer\scholarship-wepapp\client\package.json", "JSON", 0, 0, 0, 47, 0, 0, 1, 48
"c:\Users\mrtan\Desktop\Code\html\software-engineer\scholarship-wepapp\client\public\data\scholarship-form\data.json", "JSON", 0, 0, 0, 13, 0, 0, 0, 13
"c:\Users\mrtan\Desktop\Code\html\software-engineer\scholarship-wepapp\client\public\data\scholarship\l2ij35b2l3hj52b4il.json", "JSON", 0, 0, 0, 40, 0, 0, 0, 40
"c:\Users\mrtan\Desktop\Code\html\software-engineer\scholarship-wepapp\client\public\index.html", "HTML", 0, 0, 0, 0, 46, 26, 5, 77
"c:\Users\mrtan\Desktop\Code\html\software-engineer\scholarship-wepapp\client\public\manifest.json", "JSON", 0, 0, 0, 25, 0, 0, 1, 26
"c:\Users\mrtan\Desktop\Code\html\software-engineer\scholarship-wepapp\client\src\App.css", "CSS", 0, 33, 0, 0, 0, 0, 6, 39
"c:\Users\mrtan\Desktop\Code\html\software-engineer\scholarship-wepapp\client\src\App.js", "JavaScript", 16, 0, 0, 0, 0, 0, 5, 21
"c:\Users\mrtan\Desktop\Code\html\software-engineer\scholarship-wepapp\client\src\components\Login.css", "CSS", 0, 23, 0, 0, 0, 28, 5, 56
"c:\Users\mrtan\Desktop\Code\html\software-engineer\scholarship-wepapp\client\src\components\Login.js", "JavaScript", 85, 0, 0, 0, 0, 2, 15, 102
"c:\Users\mrtan\Desktop\Code\html\software-engineer\scholarship-wepapp\client\src\contents\Announcement.css", "CSS", 0, 162, 0, 0, 0, 92, 9, 263
"c:\Users\mrtan\Desktop\Code\html\software-engineer\scholarship-wepapp\client\src\contents\Announcement.js", "JavaScript", 207, 0, 0, 0, 0, 6, 14, 227
"c:\Users\mrtan\Desktop\Code\html\software-engineer\scholarship-wepapp\client\src\contents\AnnouncementLogin.css", "CSS", 0, 74, 0, 0, 0, 10, 5, 89
"c:\Users\mrtan\Desktop\Code\html\software-engineer\scholarship-wepapp\client\src\contents\AnnouncementLogin.js", "JavaScript", 58, 0, 0, 0, 0, 0, 13, 71
"c:\Users\mrtan\Desktop\Code\html\software-engineer\scholarship-wepapp\client\src\contents\Interview.css", "CSS", 0, 157, 0, 0, 0, 7, 19, 183
"c:\Users\mrtan\Desktop\Code\html\software-engineer\scholarship-wepapp\client\src\contents\Interview.js", "JavaScript", 83, 0, 0, 0, 0, 0, 18, 101
"c:\Users\mrtan\Desktop\Code\html\software-engineer\scholarship-wepapp\client\src\contents\Profile.css", "CSS", 0, 105, 0, 0, 0, 35, 16, 156
"c:\Users\mrtan\Desktop\Code\html\software-engineer\scholarship-wepapp\client\src\contents\Profile.js", "JavaScript", 64, 0, 0, 0, 0, 0, 10, 74
"c:\Users\mrtan\Desktop\Code\html\software-engineer\scholarship-wepapp\client\src\contents\Report.css", "CSS", 0, 113, 0, 0, 0, 7, 4, 124
"c:\Users\mrtan\Desktop\Code\html\software-engineer\scholarship-wepapp\client\src\contents\Report.js", "JavaScript", 86, 0, 0, 0, 0, 0, 16, 102
"c:\Users\mrtan\Desktop\Code\html\software-engineer\scholarship-wepapp\client\src\contents\RoleSetting.js", "JavaScript", 83, 0, 0, 0, 0, 1, 16, 100
"c:\Users\mrtan\Desktop\Code\html\software-engineer\scholarship-wepapp\client\src\contents\Rolesetting.css", "CSS", 0, 109, 0, 0, 0, 7, 5, 121
"c:\Users\mrtan\Desktop\Code\html\software-engineer\scholarship-wepapp\client\src\contents\SchlorshipList.css", "CSS", 0, 112, 0, 0, 0, 7, 11, 130
"c:\Users\mrtan\Desktop\Code\html\software-engineer\scholarship-wepapp\client\src\contents\ScholarshipCheck.css", "CSS", 0, 155, 0, 0, 0, 9, 22, 186
"c:\Users\mrtan\Desktop\Code\html\software-engineer\scholarship-wepapp\client\src\contents\ScholarshipCheck.js", "JavaScript", 85, 0, 0, 0, 0, 0, 17, 102
"c:\Users\mrtan\Desktop\Code\html\software-engineer\scholarship-wepapp\client\src\contents\ScholarshipList.js", "JavaScript", 88, 0, 0, 0, 0, 1, 26, 115
"c:\Users\mrtan\Desktop\Code\html\software-engineer\scholarship-wepapp\client\src\contents\ScholarshipStatus.css", "CSS", 0, 79, 0, 0, 0, 4, 4, 87
"c:\Users\mrtan\Desktop\Code\html\software-engineer\scholarship-wepapp\client\src\contents\ScholarshipStatus.js", "JavaScript", 69, 0, 0, 0, 0, 0, 12, 81
"c:\Users\mrtan\Desktop\Code\html\software-engineer\scholarship-wepapp\client\src\data\datanews.js", "JavaScript", 24, 0, 0, 0, 0, 0, 3, 27
"c:\Users\mrtan\Desktop\Code\html\software-engineer\scholarship-wepapp\client\src\index.css", "CSS", 0, 12, 0, 0, 0, 0, 2, 14
"c:\Users\mrtan\Desktop\Code\html\software-engineer\scholarship-wepapp\client\src\index.js", "JavaScript", 13, 0, 0, 0, 0, 3, 6, 22
"c:\Users\mrtan\Desktop\Code\html\software-engineer\scholarship-wepapp\client\src\modal\AlertModal.css", "CSS", 0, 16, 0, 0, 0, 0, 1, 17
"c:\Users\mrtan\Desktop\Code\html\software-engineer\scholarship-wepapp\client\src\modal\AlertModal.js", "JavaScript", 19, 0, 0, 0, 0, 0, 4, 23
"c:\Users\mrtan\Desktop\Code\html\software-engineer\scholarship-wepapp\client\src\modal\ConfirmModal.css", "CSS", 0, 43, 0, 0, 0, 0, 6, 49
"c:\Users\mrtan\Desktop\Code\html\software-engineer\scholarship-wepapp\client\src\modal\ConfirmModal.js", "JavaScript", 20, 0, 0, 0, 0, 11, 3, 34
"c:\Users\mrtan\Desktop\Code\html\software-engineer\scholarship-wepapp\client\src\modal\ImageModal.css", "CSS", 0, 36, 0, 0, 0, 0, 5, 41
"c:\Users\mrtan\Desktop\Code\html\software-engineer\scholarship-wepapp\client\src\modal\ImageModal.js", "JavaScript", 26, 0, 0, 0, 0, 0, 2, 28
"c:\Users\mrtan\Desktop\Code\html\software-engineer\scholarship-wepapp\client\src\pages\LoginPage.css", "CSS", 0, 62, 0, 0, 0, 5, 1, 68
"c:\Users\mrtan\Desktop\Code\html\software-engineer\scholarship-wepapp\client\src\pages\LoginPage.js", "JavaScript", 49, 0, 0, 0, 0, 1, 17, 67
"c:\Users\mrtan\Desktop\Code\html\software-engineer\scholarship-wepapp\client\src\pages\MainPage.css", "CSS", 0, 174, 0, 0, 0, 11, 20, 205
"c:\Users\mrtan\Desktop\Code\html\software-engineer\scholarship-wepapp\client\src\pages\MainPage.js", "JavaScript", 420, 0, 0, 0, 0, 20, 43, 483
"c:\Users\mrtan\Desktop\Code\html\software-engineer\scholarship-wepapp\client\src\reportWebVitals.js", "JavaScript", 12, 0, 0, 0, 0, 0, 2, 14
"c:\Users\mrtan\Desktop\Code\html\software-engineer\scholarship-wepapp\client\src\sub-contents\AnnouncementCreate.css", "CSS", 0, 143, 0, 0, 0, 13, 25, 181
"c:\Users\mrtan\Desktop\Code\html\software-engineer\scholarship-wepapp\client\src\sub-contents\AnnouncementCreate.js", "JavaScript", 150, 0, 0, 0, 0, 1, 17, 168
"c:\Users\mrtan\Desktop\Code\html\software-engineer\scholarship-wepapp\client\src\sub-contents\AnnouncementEdit.css", "CSS", 0, 143, 0, 0, 0, 13, 25, 181
"c:\Users\mrtan\Desktop\Code\html\software-engineer\scholarship-wepapp\client\src\sub-contents\AnnouncementEdit.js", "JavaScript", 135, 0, 0, 0, 0, 1, 16, 152
"c:\Users\mrtan\Desktop\Code\html\software-engineer\scholarship-wepapp\client\src\sub-contents\InterviewRate.css", "CSS", 0, 79, 0, 0, 0, 5, 15, 99
"c:\Users\mrtan\Desktop\Code\html\software-engineer\scholarship-wepapp\client\src\sub-contents\InterviewRate.js", "JavaScript", 69, 0, 0, 0, 0, 0, 10, 79
"c:\Users\mrtan\Desktop\Code\html\software-engineer\scholarship-wepapp\client\src\sub-contents\InterviewSchedule.css", "CSS", 0, 65, 0, 0, 0, 3, 10, 78
"c:\Users\mrtan\Desktop\Code\html\software-engineer\scholarship-wepapp\client\src\sub-contents\InterviewSchedule.js", "JavaScript", 46, 0, 0, 0, 0, 0, 7, 53
"c:\Users\mrtan\Desktop\Code\html\software-engineer\scholarship-wepapp\client\src\sub-contents\InterviewScheduleCreate.css", "CSS", 0, 0, 0, 0, 0, 0, 1, 1
"c:\Users\mrtan\Desktop\Code\html\software-engineer\scholarship-wepapp\client\src\sub-contents\InterviewScheduleCreate.js", "JavaScript", 6, 0, 0, 0, 0, 0, 4, 10
"c:\Users\mrtan\Desktop\Code\html\software-engineer\scholarship-wepapp\client\src\sub-contents\InterviewScheduleEdit.css", "CSS", 0, 0, 0, 0, 0, 0, 1, 1
"c:\Users\mrtan\Desktop\Code\html\software-engineer\scholarship-wepapp\client\src\sub-contents\InterviewScheduleEdit.js", "JavaScript", 6, 0, 0, 0, 0, 0, 4, 10
"c:\Users\mrtan\Desktop\Code\html\software-engineer\scholarship-wepapp\client\src\sub-contents\ProfileCheck.css", "CSS", 0, 88, 0, 0, 0, 33, 8, 129
"c:\Users\mrtan\Desktop\Code\html\software-engineer\scholarship-wepapp\client\src\sub-contents\ProfileCheck.js", "JavaScript", 59, 0, 0, 0, 0, 0, 12, 71
"c:\Users\mrtan\Desktop\Code\html\software-engineer\scholarship-wepapp\client\src\sub-contents\ProfileEdit.css", "CSS", 0, 106, 0, 0, 0, 5, 22, 133
"c:\Users\mrtan\Desktop\Code\html\software-engineer\scholarship-wepapp\client\src\sub-contents\ProfileEdit.js", "JavaScript", 181, 0, 0, 0, 0, 0, 14, 195
"c:\Users\mrtan\Desktop\Code\html\software-engineer\scholarship-wepapp\client\src\sub-contents\ReportInspect.css", "CSS", 0, 9472, 0, 0, 0, 514, 512, 10498
"c:\Users\mrtan\Desktop\Code\html\software-engineer\scholarship-wepapp\client\src\sub-contents\ReportInspect.js", "JavaScript", 69, 0, 0, 0, 0, 0, 8, 77
"c:\Users\mrtan\Desktop\Code\html\software-engineer\scholarship-wepapp\client\src\sub-contents\ScholarshipCheckForm.css", "CSS", 0, 155, 0, 0, 0, 8, 18, 181
"c:\Users\mrtan\Desktop\Code\html\software-engineer\scholarship-wepapp\client\src\sub-contents\ScholarshipCheckForm.js", "JavaScript", 254, 0, 0, 0, 0, 0, 16, 270
"c:\Users\mrtan\Desktop\Code\html\software-engineer\scholarship-wepapp\client\src\sub-contents\ScholarshipEdit.css", "CSS", 0, 0, 0, 0, 0, 0, 1, 1
"c:\Users\mrtan\Desktop\Code\html\software-engineer\scholarship-wepapp\client\src\sub-contents\ScholarshipEdit.js", "JavaScript", 6, 0, 0, 0, 0, 0, 4, 10
"c:\Users\mrtan\Desktop\Code\html\software-engineer\scholarship-wepapp\client\src\sub-contents\ScholarshipListCreate.css", "CSS", 0, 133, 0, 0, 0, 14, 34, 181
"c:\Users\mrtan\Desktop\Code\html\software-engineer\scholarship-wepapp\client\src\sub-contents\ScholarshipListCreate.js", "JavaScript", 141, 0, 0, 0, 0, 5, 36, 182
"c:\Users\mrtan\Desktop\Code\html\software-engineer\scholarship-wepapp\client\src\sub-contents\ScholarshipListEdit.css", "CSS", 0, 0, 0, 0, 0, 0, 1, 1
"c:\Users\mrtan\Desktop\Code\html\software-engineer\scholarship-wepapp\client\src\sub-contents\ScholarshipListEdit.js", "JavaScript", 6, 0, 0, 0, 0, 0, 4, 10
"c:\Users\mrtan\Desktop\Code\html\software-engineer\scholarship-wepapp\client\src\sub-contents\ScholarshipListRegister.css", "CSS", 0, 117, 0, 0, 0, 6, 14, 137
"c:\Users\mrtan\Desktop\Code\html\software-engineer\scholarship-wepapp\client\src\sub-contents\ScholarshipListRegister.js", "JavaScript", 241, 0, 0, 0, 0, 0, 12, 253
"c:\Users\mrtan\Desktop\Code\html\software-engineer\scholarship-wepapp\client\src\sub-contents\ScholarshipListRegister2.css", "CSS", 0, 80, 0, 0, 0, 6, 6, 92
"c:\Users\mrtan\Desktop\Code\html\software-engineer\scholarship-wepapp\client\src\sub-contents\ScholarshipListRegister2.js", "JavaScript", 76, 0, 0, 0, 0, 0, 6, 82
"c:\Users\mrtan\Desktop\Code\html\software-engineer\scholarship-wepapp\client\src\sub-contents\test.css", "CSS", 0, 30, 0, 0, 0, 0, 3, 33
"Total", "-", 2952, 12076, 39, 29265, 46, 920, 1292, 46590