"filename", "language", "JavaScript", "CSS", "SCSS", "comment", "blank", "total"
"c:\Users\Tanatorn\Desktop\Code\webdev\software-engineer\scholarship-wepapp\client\src\App.js", "JavaScript", 21, 0, 0, 0, 5, 26
"c:\Users\Tanatorn\Desktop\Code\webdev\software-engineer\scholarship-wepapp\client\src\App.scss", "SCSS", 0, 0, 2486, 63, 419, 2968
"c:\Users\Tanatorn\Desktop\Code\webdev\software-engineer\scholarship-wepapp\client\src\components\LoginGoogle.js", "JavaScript", 155, 0, 0, 3, 15, 173
"c:\Users\Tanatorn\Desktop\Code\webdev\software-engineer\scholarship-wepapp\client\src\contents\AnnouncementLogin\AnnouncementLogin.js", "JavaScript", 25, 0, 0, 0, 3, 28
"c:\Users\Tanatorn\Desktop\Code\webdev\software-engineer\scholarship-wepapp\client\src\contents\AnnouncementLogin\NewsListlogin.js", "JavaScript", 60, 0, 0, 1, 12, 73
"c:\Users\Tanatorn\Desktop\Code\webdev\software-engineer\scholarship-wepapp\client\src\contents\Announcement\AnnounceCreate.js", "JavaScript", 218, 0, 0, 1, 15, 234
"c:\Users\Tanatorn\Desktop\Code\webdev\software-engineer\scholarship-wepapp\client\src\contents\Announcement\AnnounceEdit.js", "JavaScript", 213, 0, 0, 17, 14, 244
"c:\Users\Tanatorn\Desktop\Code\webdev\software-engineer\scholarship-wepapp\client\src\contents\Announcement\AnnounceList.js", "JavaScript", 88, 0, 0, 2, 10, 100
"c:\Users\Tanatorn\Desktop\Code\webdev\software-engineer\scholarship-wepapp\client\src\contents\Announcement\Announcement.js", "JavaScript", 37, 0, 0, 1, 5, 43
"c:\Users\Tanatorn\Desktop\Code\webdev\software-engineer\scholarship-wepapp\client\src\contents\Applicant\Applicant.js", "JavaScript", 76, 0, 0, 26, 12, 114
"c:\Users\Tanatorn\Desktop\Code\webdev\software-engineer\scholarship-wepapp\client\src\contents\Applicant\ApplicantCheck.js", "JavaScript", 356, 0, 0, 6, 38, 400
"c:\Users\Tanatorn\Desktop\Code\webdev\software-engineer\scholarship-wepapp\client\src\contents\Applicant\ApplicantData.js", "JavaScript", 216, 0, 0, 3, 22, 241
"c:\Users\Tanatorn\Desktop\Code\webdev\software-engineer\scholarship-wepapp\client\src\contents\Applicant\ApplicantList.js", "JavaScript", 171, 0, 0, 5, 23, 199
"c:\Users\Tanatorn\Desktop\Code\webdev\software-engineer\scholarship-wepapp\client\src\contents\Applicant\ApplicantProfile.js", "JavaScript", 171, 0, 0, 8, 15, 194
"c:\Users\Tanatorn\Desktop\Code\webdev\software-engineer\scholarship-wepapp\client\src\contents\Interview\Interview.js", "JavaScript", 75, 0, 0, 0, 7, 82
"c:\Users\Tanatorn\Desktop\Code\webdev\software-engineer\scholarship-wepapp\client\src\contents\Interview\InterviewApprovement.js", "JavaScript", 362, 0, 0, 11, 45, 418
"c:\Users\Tanatorn\Desktop\Code\webdev\software-engineer\scholarship-wepapp\client\src\contents\Interview\InterviewData.js", "JavaScript", 259, 0, 0, 45, 32, 336
"c:\Users\Tanatorn\Desktop\Code\webdev\software-engineer\scholarship-wepapp\client\src\contents\Interview\InterviewProfile.js", "JavaScript", 168, 0, 0, 11, 15, 194
"c:\Users\Tanatorn\Desktop\Code\webdev\software-engineer\scholarship-wepapp\client\src\contents\Interview\InterviewRate.js", "JavaScript", 343, 0, 0, 17, 40, 400
"c:\Users\Tanatorn\Desktop\Code\webdev\software-engineer\scholarship-wepapp\client\src\contents\Interview\IntervieweeList.js", "JavaScript", 147, 0, 0, 4, 16, 167
"c:\Users\Tanatorn\Desktop\Code\webdev\software-engineer\scholarship-wepapp\client\src\contents\Interview\InterviewerChoose.js", "JavaScript", 242, 0, 0, 14, 28, 284
"c:\Users\Tanatorn\Desktop\Code\webdev\software-engineer\scholarship-wepapp\client\src\contents\Member\Member.js", "JavaScript", 65, 0, 0, 1, 11, 77
"c:\Users\Tanatorn\Desktop\Code\webdev\software-engineer\scholarship-wepapp\client\src\contents\Member\MemberList.js", "JavaScript", 42, 0, 0, 1, 13, 56
"c:\Users\Tanatorn\Desktop\Code\webdev\software-engineer\scholarship-wepapp\client\src\contents\Profile\FormProfile.js", "JavaScript", 156, 0, 0, 114, 17, 287
"c:\Users\Tanatorn\Desktop\Code\webdev\software-engineer\scholarship-wepapp\client\src\contents\Profile\Profile.js", "JavaScript", 181, 0, 0, 21, 18, 220
"c:\Users\Tanatorn\Desktop\Code\webdev\software-engineer\scholarship-wepapp\client\src\contents\Profile\ProfileCreate.js", "JavaScript", 300, 0, 0, 3, 28, 331
"c:\Users\Tanatorn\Desktop\Code\webdev\software-engineer\scholarship-wepapp\client\src\contents\Profile\ProfileEdit.js", "JavaScript", 332, 0, 0, 11, 30, 373
"c:\Users\Tanatorn\Desktop\Code\webdev\software-engineer\scholarship-wepapp\client\src\contents\Report\Report.js", "JavaScript", 163, 0, 0, 2, 18, 183
"c:\Users\Tanatorn\Desktop\Code\webdev\software-engineer\scholarship-wepapp\client\src\contents\Report\ReportInspect.js", "JavaScript", 169, 0, 0, 23, 24, 216
"c:\Users\Tanatorn\Desktop\Code\webdev\software-engineer\scholarship-wepapp\client\src\contents\Report\ReportList.js", "JavaScript", 184, 0, 0, 4, 16, 204
"c:\Users\Tanatorn\Desktop\Code\webdev\software-engineer\scholarship-wepapp\client\src\contents\RoleSetting\RoleList.js", "JavaScript", 94, 0, 0, 1, 17, 112
"c:\Users\Tanatorn\Desktop\Code\webdev\software-engineer\scholarship-wepapp\client\src\contents\RoleSetting\RoleSetting.js", "JavaScript", 69, 0, 0, 1, 13, 83
"c:\Users\Tanatorn\Desktop\Code\webdev\software-engineer\scholarship-wepapp\client\src\contents\Scholarship\CreateAttrform.js", "JavaScript", 85, 0, 0, 0, 8, 93
"c:\Users\Tanatorn\Desktop\Code\webdev\software-engineer\scholarship-wepapp\client\src\contents\Scholarship\CreateDetail.js", "JavaScript", 300, 0, 0, 15, 22, 337
"c:\Users\Tanatorn\Desktop\Code\webdev\software-engineer\scholarship-wepapp\client\src\contents\Scholarship\CreateFileform.js", "JavaScript", 204, 0, 0, 5, 11, 220
"c:\Users\Tanatorn\Desktop\Code\webdev\software-engineer\scholarship-wepapp\client\src\contents\Scholarship\CreateRateform.js", "JavaScript", 171, 0, 0, 1, 15, 187
"c:\Users\Tanatorn\Desktop\Code\webdev\software-engineer\scholarship-wepapp\client\src\contents\Scholarship\EditAttrform.js", "JavaScript", 89, 0, 0, 0, 9, 98
"c:\Users\Tanatorn\Desktop\Code\webdev\software-engineer\scholarship-wepapp\client\src\contents\Scholarship\EditDetail.js", "JavaScript", 314, 0, 0, 6, 29, 349
"c:\Users\Tanatorn\Desktop\Code\webdev\software-engineer\scholarship-wepapp\client\src\contents\Scholarship\EditFileform.js", "JavaScript", 208, 0, 0, 8, 17, 233
"c:\Users\Tanatorn\Desktop\Code\webdev\software-engineer\scholarship-wepapp\client\src\contents\Scholarship\EditRateform.js", "JavaScript", 174, 0, 0, 3, 15, 192
"c:\Users\Tanatorn\Desktop\Code\webdev\software-engineer\scholarship-wepapp\client\src\contents\Scholarship\EditScholarshipRegister.js", "JavaScript", 358, 0, 0, 22, 33, 413
"c:\Users\Tanatorn\Desktop\Code\webdev\software-engineer\scholarship-wepapp\client\src\contents\Scholarship\Scholarship.js", "JavaScript", 38, 0, 0, 0, 8, 46
"c:\Users\Tanatorn\Desktop\Code\webdev\software-engineer\scholarship-wepapp\client\src\contents\Scholarship\ScholarshipCreate.js", "JavaScript", 130, 0, 0, 5, 18, 153
"c:\Users\Tanatorn\Desktop\Code\webdev\software-engineer\scholarship-wepapp\client\src\contents\Scholarship\ScholarshipEdit.js", "JavaScript", 134, 0, 0, 3, 18, 155
"c:\Users\Tanatorn\Desktop\Code\webdev\software-engineer\scholarship-wepapp\client\src\contents\Scholarship\ScholarshipList.js", "JavaScript", 291, 0, 0, 5, 32, 328
"c:\Users\Tanatorn\Desktop\Code\webdev\software-engineer\scholarship-wepapp\client\src\contents\Scholarship\ScholarshipRegister.js", "JavaScript", 360, 0, 0, 8, 39, 407
"c:\Users\Tanatorn\Desktop\Code\webdev\software-engineer\scholarship-wepapp\client\src\contents\Status\Status.js", "JavaScript", 56, 0, 0, 0, 7, 63
"c:\Users\Tanatorn\Desktop\Code\webdev\software-engineer\scholarship-wepapp\client\src\contents\Status\StatusList.js", "JavaScript", 291, 0, 0, 27, 32, 350
"c:\Users\Tanatorn\Desktop\Code\webdev\software-engineer\scholarship-wepapp\client\src\context\WebContext.js", "JavaScript", 65, 0, 0, 3, 11, 79
"c:\Users\Tanatorn\Desktop\Code\webdev\software-engineer\scholarship-wepapp\client\src\controller\Controllers.js", "JavaScript", 15, 0, 0, 1, 3, 19
"c:\Users\Tanatorn\Desktop\Code\webdev\software-engineer\scholarship-wepapp\client\src\controller\LoginController.js", "JavaScript", 17, 0, 0, 48, 6, 71
"c:\Users\Tanatorn\Desktop\Code\webdev\software-engineer\scholarship-wepapp\client\src\controller\MainController.js", "JavaScript", 71, 0, 0, 9, 8, 88
"c:\Users\Tanatorn\Desktop\Code\webdev\software-engineer\scholarship-wepapp\client\src\controller\ScholarshipController.js", "JavaScript", 46, 0, 0, 1, 6, 53
"c:\Users\Tanatorn\Desktop\Code\webdev\software-engineer\scholarship-wepapp\client\src\data\datanews.js", "JavaScript", 24, 0, 0, 0, 3, 27
"c:\Users\Tanatorn\Desktop\Code\webdev\software-engineer\scholarship-wepapp\client\src\data\test.js", "JavaScript", 11, 0, 0, 0, 3, 14
"c:\Users\Tanatorn\Desktop\Code\webdev\software-engineer\scholarship-wepapp\client\src\index.css", "CSS", 0, 12, 0, 0, 2, 14
"c:\Users\Tanatorn\Desktop\Code\webdev\software-engineer\scholarship-wepapp\client\src\index.js", "JavaScript", 13, 0, 0, 3, 6, 22
"c:\Users\Tanatorn\Desktop\Code\webdev\software-engineer\scholarship-wepapp\client\src\pages\LoginPage.js", "JavaScript", 44, 0, 0, 0, 9, 53
"c:\Users\Tanatorn\Desktop\Code\webdev\software-engineer\scholarship-wepapp\client\src\pages\MainPage.js", "JavaScript", 241, 0, 0, 3, 33, 277
"c:\Users\Tanatorn\Desktop\Code\webdev\software-engineer\scholarship-wepapp\client\src\reportWebVitals.js", "JavaScript", 12, 0, 0, 0, 2, 14
"Total", "-", 8920, 12, 2486, 596, 1401, 13415