"filename", "language", "JavaScript", "CSS", "comment", "blank", "total"
"c:\Users\mrtan\Desktop\Code\html\software-engineer\scholarship-wepapp\client\src\contents\Announcement.js", "JavaScript", 71, 0, 1, -2, 70
"c:\Users\mrtan\Desktop\Code\html\software-engineer\scholarship-wepapp\client\src\contents\RoleSetting.js", "JavaScript", 11, 0, 1, 2, 14
"c:\Users\mrtan\Desktop\Code\html\software-engineer\scholarship-wepapp\client\src\contents\Rolesetting.css", "CSS", 0, 6, 0, 0, 6
"c:\Users\mrtan\Desktop\Code\html\software-engineer\scholarship-wepapp\client\src\contents\ScholarshipCheck.css", "CSS", 0, 0, 0, -2, -2
"c:\Users\mrtan\Desktop\Code\html\software-engineer\scholarship-wepapp\client\src\pages\MainPage.css", "CSS", 0, -1, 0, 0, -1
"c:\Users\mrtan\Desktop\Code\html\software-engineer\scholarship-wepapp\client\src\pages\MainPage.js", "JavaScript", 1, 0, 0, 1, 2
"c:\Users\mrtan\Desktop\Code\html\software-engineer\scholarship-wepapp\client\src\sub-contents\AnnouncementCreate.css", "CSS", 0, 1, 0, 0, 1
"c:\Users\mrtan\Desktop\Code\html\software-engineer\scholarship-wepapp\client\src\sub-contents\AnnouncementCreate.js", "JavaScript", 14, 0, 0, 0, 14
"c:\Users\mrtan\Desktop\Code\html\software-engineer\scholarship-wepapp\client\src\sub-contents\AnnouncementEdit.css", "CSS", 0, 143, 13, 24, 180
"c:\Users\mrtan\Desktop\Code\html\software-engineer\scholarship-wepapp\client\src\sub-contents\AnnouncementEdit.js", "JavaScript", 69, 0, -2, 5, 72
"c:\Users\mrtan\Desktop\Code\html\software-engineer\scholarship-wepapp\client\src\sub-contents\ReportInspect.css", "CSS", 0, 1, 0, 1, 2
"c:\Users\mrtan\Desktop\Code\html\software-engineer\scholarship-wepapp\client\src\sub-contents\ScholarshipListCreate.js", "JavaScript", -5, 0, 0, 4, -1
"Total", "-", 161, 150, 13, 33, 357