"filename", "language", "CSS", "JavaScript", "JSON", "SCSS", "comment", "blank", "total"
"c:\Users\mrtan\Desktop\Code\html\software-engineer\scholarship-wepapp\client\package-lock.json", "JSON", 0, 0, 37, 0, 0, 0, 37
"c:\Users\mrtan\Desktop\Code\html\software-engineer\scholarship-wepapp\client\package.json", "JSON", 0, 0, 1, 0, 0, 0, 1
"c:\Users\mrtan\Desktop\Code\html\software-engineer\scholarship-wepapp\client\src\App.css", "CSS", -33, 0, 0, 0, 0, -6, -39
"c:\Users\mrtan\Desktop\Code\html\software-engineer\scholarship-wepapp\client\src\App.js", "JavaScript", 0, 28, 0, 0, 17, 5, 50
"c:\Users\mrtan\Desktop\Code\html\software-engineer\scholarship-wepapp\client\src\App.scss", "SCSS", 0, 0, 0, 1049, 86, 143, 1278
"c:\Users\mrtan\Desktop\Code\html\software-engineer\scholarship-wepapp\client\src\components\ApplicantList.js", "JavaScript", 0, 40, 0, 0, 4, 11, 55
"c:\Users\mrtan\Desktop\Code\html\software-engineer\scholarship-wepapp\client\src\components\IntervieweeList.js", "JavaScript", 0, 48, 0, 0, 4, 12, 64
"c:\Users\mrtan\Desktop\Code\html\software-engineer\scholarship-wepapp\client\src\components\Login.js", "JavaScript", 0, 0, 0, 0, 0, -1, -1
"c:\Users\mrtan\Desktop\Code\html\software-engineer\scholarship-wepapp\client\src\components\NewsList.js", "JavaScript", 0, 144, 0, 0, 7, 23, 174
"c:\Users\mrtan\Desktop\Code\html\software-engineer\scholarship-wepapp\client\src\components\NewsListlogin.js", "JavaScript", 0, 42, 0, 0, 0, 9, 51
"c:\Users\mrtan\Desktop\Code\html\software-engineer\scholarship-wepapp\client\src\components\ReportList.js", "JavaScript", 0, 23, 0, 0, 0, 3, 26
"c:\Users\mrtan\Desktop\Code\html\software-engineer\scholarship-wepapp\client\src\components\RoleList.js", "JavaScript", 0, 71, 0, 0, 0, 11, 82
"c:\Users\mrtan\Desktop\Code\html\software-engineer\scholarship-wepapp\client\src\components\ScholarshipList.js", "JavaScript", 0, 43, 0, 0, 0, 9, 52
"c:\Users\mrtan\Desktop\Code\html\software-engineer\scholarship-wepapp\client\src\components\Scholarshipstatus.js", "JavaScript", 0, 44, 0, 0, 4, 11, 59
"c:\Users\mrtan\Desktop\Code\html\software-engineer\scholarship-wepapp\client\src\components\StatusList.js", "JavaScript", 0, 44, 0, 0, 4, 4, 52
"c:\Users\mrtan\Desktop\Code\html\software-engineer\scholarship-wepapp\client\src\contents\Announcement.css", "CSS", -162, 0, 0, 0, -92, -9, -263
"c:\Users\mrtan\Desktop\Code\html\software-engineer\scholarship-wepapp\client\src\contents\Announcement.js", "JavaScript", 0, -180, 0, 0, -6, -10, -196
"c:\Users\mrtan\Desktop\Code\html\software-engineer\scholarship-wepapp\client\src\contents\AnnouncementLogin.css", "CSS", -74, 0, 0, 0, -10, -5, -89
"c:\Users\mrtan\Desktop\Code\html\software-engineer\scholarship-wepapp\client\src\contents\AnnouncementLogin.js", "JavaScript", 0, -38, 0, 0, 0, -10, -48
"c:\Users\mrtan\Desktop\Code\html\software-engineer\scholarship-wepapp\client\src\contents\Applicant.js", "JavaScript", 0, 41, 0, 0, 0, 4, 45
"c:\Users\mrtan\Desktop\Code\html\software-engineer\scholarship-wepapp\client\src\contents\Interview.css", "CSS", -157, 0, 0, 0, -7, -19, -183
"c:\Users\mrtan\Desktop\Code\html\software-engineer\scholarship-wepapp\client\src\contents\Interview.js", "JavaScript", 0, -41, 0, 0, 0, -13, -54
"c:\Users\mrtan\Desktop\Code\html\software-engineer\scholarship-wepapp\client\src\contents\Profile.css", "CSS", -105, 0, 0, 0, -35, -16, -156
"c:\Users\mrtan\Desktop\Code\html\software-engineer\scholarship-wepapp\client\src\contents\Profile.js", "JavaScript", 0, 19, 0, 0, 0, 0, 19
"c:\Users\mrtan\Desktop\Code\html\software-engineer\scholarship-wepapp\client\src\contents\Report.css", "CSS", -113, 0, 0, 0, -7, -4, -124
"c:\Users\mrtan\Desktop\Code\html\software-engineer\scholarship-wepapp\client\src\contents\Report.js", "JavaScript", 0, -33, 0, 0, 0, -12, -45
"c:\Users\mrtan\Desktop\Code\html\software-engineer\scholarship-wepapp\client\src\contents\RoleSetting.js", "JavaScript", 0, -52, 0, 0, -1, -8, -61
"c:\Users\mrtan\Desktop\Code\html\software-engineer\scholarship-wepapp\client\src\contents\Rolesetting.css", "CSS", -109, 0, 0, 0, -7, -5, -121
"c:\Users\mrtan\Desktop\Code\html\software-engineer\scholarship-wepapp\client\src\contents\SchlorshipList.css", "CSS", -112, 0, 0, 0, -7, -11, -130
"c:\Users\mrtan\Desktop\Code\html\software-engineer\scholarship-wepapp\client\src\contents\Scholarship.js", "JavaScript", 0, 28, 0, 0, 0, 7, 35
"c:\Users\mrtan\Desktop\Code\html\software-engineer\scholarship-wepapp\client\src\contents\ScholarshipCheck.css", "CSS", -155, 0, 0, 0, -9, -22, -186
"c:\Users\mrtan\Desktop\Code\html\software-engineer\scholarship-wepapp\client\src\contents\ScholarshipCheck.js", "JavaScript", 0, -85, 0, 0, 0, -17, -102
"c:\Users\mrtan\Desktop\Code\html\software-engineer\scholarship-wepapp\client\src\contents\ScholarshipList.js", "JavaScript", 0, -88, 0, 0, -1, -26, -115
"c:\Users\mrtan\Desktop\Code\html\software-engineer\scholarship-wepapp\client\src\contents\ScholarshipStatus.css", "CSS", -79, 0, 0, 0, -4, -4, -87
"c:\Users\mrtan\Desktop\Code\html\software-engineer\scholarship-wepapp\client\src\contents\ScholarshipStatus.js", "JavaScript", 0, -69, 0, 0, 0, -12, -81
"c:\Users\mrtan\Desktop\Code\html\software-engineer\scholarship-wepapp\client\src\contents\Status.js", "JavaScript", 0, 20, 0, 0, 0, 3, 23
"c:\Users\mrtan\Desktop\Code\html\software-engineer\scholarship-wepapp\client\src\data\profile.json", "JSON", 0, 0, 41, 0, 0, 1, 42
"c:\Users\mrtan\Desktop\Code\html\software-engineer\scholarship-wepapp\client\src\modal\AlertModal.css", "CSS", -16, 0, 0, 0, 0, -1, -17
"c:\Users\mrtan\Desktop\Code\html\software-engineer\scholarship-wepapp\client\src\modal\AlertModal.js", "JavaScript", 0, -19, 0, 0, 0, -4, -23
"c:\Users\mrtan\Desktop\Code\html\software-engineer\scholarship-wepapp\client\src\modal\ConfirmModal.css", "CSS", -43, 0, 0, 0, 0, -6, -49
"c:\Users\mrtan\Desktop\Code\html\software-engineer\scholarship-wepapp\client\src\modal\ConfirmModal.js", "JavaScript", 0, -20, 0, 0, -11, -3, -34
"c:\Users\mrtan\Desktop\Code\html\software-engineer\scholarship-wepapp\client\src\modal\ImageModal.css", "CSS", -36, 0, 0, 0, 0, -5, -41
"c:\Users\mrtan\Desktop\Code\html\software-engineer\scholarship-wepapp\client\src\modal\ImageModal.js", "JavaScript", 0, -26, 0, 0, 0, -2, -28
"c:\Users\mrtan\Desktop\Code\html\software-engineer\scholarship-wepapp\client\src\modals\AlertModal.css", "CSS", 14, 0, 0, 0, 10, 6, 30
"c:\Users\mrtan\Desktop\Code\html\software-engineer\scholarship-wepapp\client\src\modals\AlertModal.js", "JavaScript", 0, 29, 0, 0, 0, 4, 33
"c:\Users\mrtan\Desktop\Code\html\software-engineer\scholarship-wepapp\client\src\modals\ConfirmModal.css", "CSS", 0, 0, 0, 0, 48, 1, 49
"c:\Users\mrtan\Desktop\Code\html\software-engineer\scholarship-wepapp\client\src\modals\ConfirmModal.js", "JavaScript", 0, 20, 0, 0, 11, 3, 34
"c:\Users\mrtan\Desktop\Code\html\software-engineer\scholarship-wepapp\client\src\modals\ImageModal.css", "CSS", 36, 0, 0, 0, 0, 5, 41
"c:\Users\mrtan\Desktop\Code\html\software-engineer\scholarship-wepapp\client\src\modals\ImageModal.js", "JavaScript", 0, 26, 0, 0, 0, 2, 28
"c:\Users\mrtan\Desktop\Code\html\software-engineer\scholarship-wepapp\client\src\pages\LoginPage.js", "JavaScript", 0, -1, 0, 0, -1, -4, -6
"c:\Users\mrtan\Desktop\Code\html\software-engineer\scholarship-wepapp\client\src\pages\MainPage.css", "CSS", -85, 0, 0, 0, 110, 6, 31
"c:\Users\mrtan\Desktop\Code\html\software-engineer\scholarship-wepapp\client\src\pages\MainPage.js", "JavaScript", 0, -123, 0, 0, -7, -18, -148
"c:\Users\mrtan\Desktop\Code\html\software-engineer\scholarship-wepapp\client\src\sub-contents\AnnouncementCreate.css", "CSS", -124, 0, 0, 0, 158, -13, 21
"c:\Users\mrtan\Desktop\Code\html\software-engineer\scholarship-wepapp\client\src\sub-contents\AnnouncementCreate.js", "JavaScript", 0, -22, 0, 0, 0, -5, -27
"c:\Users\mrtan\Desktop\Code\html\software-engineer\scholarship-wepapp\client\src\sub-contents\AnnouncementEdit.css", "CSS", -16, 0, 0, 0, 16, 0, 0
"c:\Users\mrtan\Desktop\Code\html\software-engineer\scholarship-wepapp\client\src\sub-contents\AnnouncementEdit.js", "JavaScript", 0, 20, 0, 0, 0, 3, 23
"c:\Users\mrtan\Desktop\Code\html\software-engineer\scholarship-wepapp\client\src\sub-contents\Assessment.js", "JavaScript", 0, 0, 0, 0, 43, 0, 43
"c:\Users\mrtan\Desktop\Code\html\software-engineer\scholarship-wepapp\client\src\sub-contents\InterviewRate.css", "CSS", -9, 0, 0, 0, 9, 1, 1
"c:\Users\mrtan\Desktop\Code\html\software-engineer\scholarship-wepapp\client\src\sub-contents\InterviewRate.js", "JavaScript", 0, -6, 0, 0, 0, -6, -12
"c:\Users\mrtan\Desktop\Code\html\software-engineer\scholarship-wepapp\client\src\sub-contents\InterviewSchedule.js", "JavaScript", 0, -3, 0, 0, 0, 0, -3
"c:\Users\mrtan\Desktop\Code\html\software-engineer\scholarship-wepapp\client\src\sub-contents\InterviewScheduleCreate.js", "JavaScript", 0, 3, 0, 0, 0, 0, 3
"c:\Users\mrtan\Desktop\Code\html\software-engineer\scholarship-wepapp\client\src\sub-contents\InterviewScheduleEdit.js", "JavaScript", 0, 3, 0, 0, 0, 0, 3
"c:\Users\mrtan\Desktop\Code\html\software-engineer\scholarship-wepapp\client\src\sub-contents\ProfileCheck.css", "CSS", -88, 0, 0, 0, 112, -3, 21
"c:\Users\mrtan\Desktop\Code\html\software-engineer\scholarship-wepapp\client\src\sub-contents\ProfileCheck.js", "JavaScript", 0, -1, 0, 0, 0, -3, -4
"c:\Users\mrtan\Desktop\Code\html\software-engineer\scholarship-wepapp\client\src\sub-contents\ProfileCreate.js", "JavaScript", 0, 207, 0, 0, 0, 18, 225
"c:\Users\mrtan\Desktop\Code\html\software-engineer\scholarship-wepapp\client\src\sub-contents\ProfileEdit.css", "CSS", -106, 0, 0, 0, 112, -6, 0
"c:\Users\mrtan\Desktop\Code\html\software-engineer\scholarship-wepapp\client\src\sub-contents\ProfileEdit.js", "JavaScript", 0, -8, 0, 0, 0, -1, -9
"c:\Users\mrtan\Desktop\Code\html\software-engineer\scholarship-wepapp\client\src\sub-contents\ReportInspect.css", "CSS", -9425, 0, 0, 0, -509, -509, -10443
"c:\Users\mrtan\Desktop\Code\html\software-engineer\scholarship-wepapp\client\src\sub-contents\ReportInspect.js", "JavaScript", 0, 0, 0, 0, 0, -4, -4
"c:\Users\mrtan\Desktop\Code\html\software-engineer\scholarship-wepapp\client\src\sub-contents\ScholarshipCheckForm.css", "CSS", -155, 0, 0, 0, 185, -16, 14
"c:\Users\mrtan\Desktop\Code\html\software-engineer\scholarship-wepapp\client\src\sub-contents\ScholarshipCheckForm.js", "JavaScript", 0, -18, 0, 0, 0, 21, 3
"c:\Users\mrtan\Desktop\Code\html\software-engineer\scholarship-wepapp\client\src\sub-contents\ScholarshipEdit.js", "JavaScript", 0, 3, 0, 0, 0, 1, 4
"c:\Users\mrtan\Desktop\Code\html\software-engineer\scholarship-wepapp\client\src\sub-contents\ScholarshipListCreate.css", "CSS", -108, 0, 0, 0, 291, -12, 171
"c:\Users\mrtan\Desktop\Code\html\software-engineer\scholarship-wepapp\client\src\sub-contents\ScholarshipListCreate.js", "JavaScript", 0, 111, 0, 0, -1, -5, 105
"c:\Users\mrtan\Desktop\Code\html\software-engineer\scholarship-wepapp\client\src\sub-contents\ScholarshipListEdit.js", "JavaScript", 0, 3, 0, 0, 0, 2, 5
"c:\Users\mrtan\Desktop\Code\html\software-engineer\scholarship-wepapp\client\src\sub-contents\ScholarshipListRegister.css", "CSS", -56, 0, 0, 0, 64, 0, 8
"c:\Users\mrtan\Desktop\Code\html\software-engineer\scholarship-wepapp\client\src\sub-contents\ScholarshipListRegister.js", "JavaScript", 0, 2, 0, 0, 0, -1, 1
"c:\Users\mrtan\Desktop\Code\html\software-engineer\scholarship-wepapp\client\src\sub-contents\ScholarshipListRegister2.js", "JavaScript", 0, 2, 0, 0, 0, 0, 2
"Total", "-", -11316, 231, 79, 1049, 580, -508, -9885