"filename", "language", "JavaScript", "CSS", "JSON", "comment", "blank", "total"
"c:\Users\mrtan\Desktop\Code\html\software-engineer\scholarship-wepapp\client\src\App.css", "CSS", 0, 33, 0, 0, 6, 39
"c:\Users\mrtan\Desktop\Code\html\software-engineer\scholarship-wepapp\client\src\App.js", "JavaScript", 16, 0, 0, 0, 5, 21
"c:\Users\mrtan\Desktop\Code\html\software-engineer\scholarship-wepapp\client\src\components\Login.css", "CSS", 0, 23, 0, 28, 5, 56
"c:\Users\mrtan\Desktop\Code\html\software-engineer\scholarship-wepapp\client\src\components\Login.js", "JavaScript", 85, 0, 0, 2, 15, 102
"c:\Users\mrtan\Desktop\Code\html\software-engineer\scholarship-wepapp\client\src\contents\Announcement.css", "CSS", 0, 119, 0, 8, 21, 148
"c:\Users\mrtan\Desktop\Code\html\software-engineer\scholarship-wepapp\client\src\contents\Announcement.js", "JavaScript", 97, 0, 0, 5, 30, 132
"c:\Users\mrtan\Desktop\Code\html\software-engineer\scholarship-wepapp\client\src\contents\AnnouncementLogin.css", "CSS", 0, 74, 0, 6, 7, 87
"c:\Users\mrtan\Desktop\Code\html\software-engineer\scholarship-wepapp\client\src\contents\AnnouncementLogin.js", "JavaScript", 58, 0, 0, 0, 13, 71
"c:\Users\mrtan\Desktop\Code\html\software-engineer\scholarship-wepapp\client\src\contents\Interview.css", "CSS", 0, 156, 0, 3, 22, 181
"c:\Users\mrtan\Desktop\Code\html\software-engineer\scholarship-wepapp\client\src\contents\Interview.js", "JavaScript", 83, 0, 0, 0, 20, 103
"c:\Users\mrtan\Desktop\Code\html\software-engineer\scholarship-wepapp\client\src\contents\Profile.css", "CSS", 0, 106, 0, 28, 17, 151
"c:\Users\mrtan\Desktop\Code\html\software-engineer\scholarship-wepapp\client\src\contents\Profile.js", "JavaScript", 64, 0, 0, 0, 9, 73
"c:\Users\mrtan\Desktop\Code\html\software-engineer\scholarship-wepapp\client\src\contents\Report.css", "CSS", 0, 63, 0, 2, 7, 72
"c:\Users\mrtan\Desktop\Code\html\software-engineer\scholarship-wepapp\client\src\contents\Report.js", "JavaScript", 81, 0, 0, 0, 16, 97
"c:\Users\mrtan\Desktop\Code\html\software-engineer\scholarship-wepapp\client\src\contents\RoleSetting.js", "JavaScript", 53, 0, 0, 0, 6, 59
"c:\Users\mrtan\Desktop\Code\html\software-engineer\scholarship-wepapp\client\src\contents\Rolesetting.css", "CSS", 0, 64, 0, 0, 4, 68
"c:\Users\mrtan\Desktop\Code\html\software-engineer\scholarship-wepapp\client\src\contents\SchlorshipList.css", "CSS", 0, 120, 0, 1, 13, 134
"c:\Users\mrtan\Desktop\Code\html\software-engineer\scholarship-wepapp\client\src\contents\ScholarshipCheck.css", "CSS", 0, 9, 0, 0, 0, 9
"c:\Users\mrtan\Desktop\Code\html\software-engineer\scholarship-wepapp\client\src\contents\ScholarshipCheck.js", "JavaScript", 80, 0, 0, 0, 20, 100
"c:\Users\mrtan\Desktop\Code\html\software-engineer\scholarship-wepapp\client\src\contents\ScholarshipList.js", "JavaScript", 82, 0, 0, 0, 17, 99
"c:\Users\mrtan\Desktop\Code\html\software-engineer\scholarship-wepapp\client\src\contents\ScholarshipStatus.css", "CSS", 0, 79, 0, 0, 4, 83
"c:\Users\mrtan\Desktop\Code\html\software-engineer\scholarship-wepapp\client\src\contents\ScholarshipStatus.js", "JavaScript", 69, 0, 0, 0, 12, 81
"c:\Users\mrtan\Desktop\Code\html\software-engineer\scholarship-wepapp\client\src\data\datanews.js", "JavaScript", 24, 0, 0, 0, 3, 27
"c:\Users\mrtan\Desktop\Code\html\software-engineer\scholarship-wepapp\client\src\data\scholarship-form\lo23j4g5v3.json", "JSON", 0, 0, 14, 0, 1, 15
"c:\Users\mrtan\Desktop\Code\html\software-engineer\scholarship-wepapp\client\src\index.css", "CSS", 0, 12, 0, 0, 2, 14
"c:\Users\mrtan\Desktop\Code\html\software-engineer\scholarship-wepapp\client\src\index.js", "JavaScript", 13, 0, 0, 3, 6, 22
"c:\Users\mrtan\Desktop\Code\html\software-engineer\scholarship-wepapp\client\src\modal\AlertModal.css", "CSS", 0, 16, 0, 0, 1, 17
"c:\Users\mrtan\Desktop\Code\html\software-engineer\scholarship-wepapp\client\src\modal\AlertModal.js", "JavaScript", 19, 0, 0, 0, 4, 23
"c:\Users\mrtan\Desktop\Code\html\software-engineer\scholarship-wepapp\client\src\modal\ConfirmModal.css", "CSS", 0, 16, 0, 0, 0, 16
"c:\Users\mrtan\Desktop\Code\html\software-engineer\scholarship-wepapp\client\src\modal\ConfirmModal.js", "JavaScript", 30, 0, 0, 1, 7, 38
"c:\Users\mrtan\Desktop\Code\html\software-engineer\scholarship-wepapp\client\src\pages\LoginPage.css", "CSS", 0, 62, 0, 5, 1, 68
"c:\Users\mrtan\Desktop\Code\html\software-engineer\scholarship-wepapp\client\src\pages\LoginPage.js", "JavaScript", 65, 0, 0, 1, 18, 84
"c:\Users\mrtan\Desktop\Code\html\software-engineer\scholarship-wepapp\client\src\pages\MainPage.css", "CSS", 0, 169, 0, 8, 13, 190
"c:\Users\mrtan\Desktop\Code\html\software-engineer\scholarship-wepapp\client\src\pages\MainPage.js", "JavaScript", 415, 0, 0, 20, 40, 475
"c:\Users\mrtan\Desktop\Code\html\software-engineer\scholarship-wepapp\client\src\reportWebVitals.js", "JavaScript", 12, 0, 0, 0, 2, 14
"c:\Users\mrtan\Desktop\Code\html\software-engineer\scholarship-wepapp\client\src\services\firebase.js", "JavaScript", 17, 0, 0, 4, 7, 28
"c:\Users\mrtan\Desktop\Code\html\software-engineer\scholarship-wepapp\client\src\sub-contents\AnnouncementCreate.css", "CSS", 0, 130, 0, 9, 34, 173
"c:\Users\mrtan\Desktop\Code\html\software-engineer\scholarship-wepapp\client\src\sub-contents\AnnouncementCreate.js", "JavaScript", 60, 0, 0, 5, 21, 86
"c:\Users\mrtan\Desktop\Code\html\software-engineer\scholarship-wepapp\client\src\sub-contents\AnnouncementEdit.css", "CSS", 0, 0, 0, 0, 1, 1
"c:\Users\mrtan\Desktop\Code\html\software-engineer\scholarship-wepapp\client\src\sub-contents\AnnouncementEdit.js", "JavaScript", 6, 0, 0, 0, 4, 10
"c:\Users\mrtan\Desktop\Code\html\software-engineer\scholarship-wepapp\client\src\sub-contents\InterviewRate.css", "CSS", 0, 0, 0, 0, 1, 1
"c:\Users\mrtan\Desktop\Code\html\software-engineer\scholarship-wepapp\client\src\sub-contents\InterviewRate.js", "JavaScript", 11, 0, 0, 0, 3, 14
"c:\Users\mrtan\Desktop\Code\html\software-engineer\scholarship-wepapp\client\src\sub-contents\InterviewSchedule.css", "CSS", 0, 0, 0, 0, 1, 1
"c:\Users\mrtan\Desktop\Code\html\software-engineer\scholarship-wepapp\client\src\sub-contents\InterviewSchedule.js", "JavaScript", 6, 0, 0, 0, 3, 9
"c:\Users\mrtan\Desktop\Code\html\software-engineer\scholarship-wepapp\client\src\sub-contents\InterviewScheduleCreate.css", "CSS", 0, 0, 0, 0, 1, 1
"c:\Users\mrtan\Desktop\Code\html\software-engineer\scholarship-wepapp\client\src\sub-contents\InterviewScheduleCreate.js", "JavaScript", 6, 0, 0, 0, 4, 10
"c:\Users\mrtan\Desktop\Code\html\software-engineer\scholarship-wepapp\client\src\sub-contents\InterviewScheduleEdit.css", "CSS", 0, 0, 0, 0, 1, 1
"c:\Users\mrtan\Desktop\Code\html\software-engineer\scholarship-wepapp\client\src\sub-contents\InterviewScheduleEdit.js", "JavaScript", 6, 0, 0, 0, 4, 10
"c:\Users\mrtan\Desktop\Code\html\software-engineer\scholarship-wepapp\client\src\sub-contents\ProfileCheck.css", "CSS", 0, 0, 0, 0, 1, 1
"c:\Users\mrtan\Desktop\Code\html\software-engineer\scholarship-wepapp\client\src\sub-contents\ProfileCheck.js", "JavaScript", 64, 0, 0, 0, 10, 74
"c:\Users\mrtan\Desktop\Code\html\software-engineer\scholarship-wepapp\client\src\sub-contents\ProfileEdit.css", "CSS", 0, 80, 0, 2, 13, 95
"c:\Users\mrtan\Desktop\Code\html\software-engineer\scholarship-wepapp\client\src\sub-contents\ProfileEdit.js", "JavaScript", 148, 0, 0, 0, 12, 160
"c:\Users\mrtan\Desktop\Code\html\software-engineer\scholarship-wepapp\client\src\sub-contents\ReportInspect.css", "CSS", 0, 0, 0, 0, 1, 1
"c:\Users\mrtan\Desktop\Code\html\software-engineer\scholarship-wepapp\client\src\sub-contents\ReportInspect.js", "JavaScript", 6, 0, 0, 0, 4, 10
"c:\Users\mrtan\Desktop\Code\html\software-engineer\scholarship-wepapp\client\src\sub-contents\ScholarshipCheckForm.css", "CSS", 0, 0, 0, 0, 1, 1
"c:\Users\mrtan\Desktop\Code\html\software-engineer\scholarship-wepapp\client\src\sub-contents\ScholarshipCheckForm.js", "JavaScript", 6, 0, 0, 0, 3, 9
"c:\Users\mrtan\Desktop\Code\html\software-engineer\scholarship-wepapp\client\src\sub-contents\ScholarshipEdit.css", "CSS", 0, 0, 0, 0, 1, 1
"c:\Users\mrtan\Desktop\Code\html\software-engineer\scholarship-wepapp\client\src\sub-contents\ScholarshipEdit.js", "JavaScript", 6, 0, 0, 0, 4, 10
"c:\Users\mrtan\Desktop\Code\html\software-engineer\scholarship-wepapp\client\src\sub-contents\ScholarshipListCreate.css", "CSS", 0, 139, 0, 9, 35, 183
"c:\Users\mrtan\Desktop\Code\html\software-engineer\scholarship-wepapp\client\src\sub-contents\ScholarshipListCreate.js", "JavaScript", 79, 0, 0, 5, 29, 113
"c:\Users\mrtan\Desktop\Code\html\software-engineer\scholarship-wepapp\client\src\sub-contents\ScholarshipListEdit.css", "CSS", 0, 0, 0, 0, 1, 1
"c:\Users\mrtan\Desktop\Code\html\software-engineer\scholarship-wepapp\client\src\sub-contents\ScholarshipListEdit.js", "JavaScript", 6, 0, 0, 0, 4, 10
"c:\Users\mrtan\Desktop\Code\html\software-engineer\scholarship-wepapp\client\src\sub-contents\ScholarshipListRegister.css", "CSS", 0, 80, 0, 2, 6, 88
"c:\Users\mrtan\Desktop\Code\html\software-engineer\scholarship-wepapp\client\src\sub-contents\ScholarshipListRegister.js", "JavaScript", 75, 0, 0, 0, 10, 85
"Total", "-", 1848, 1550, 14, 157, 587, 4156