"filename", "language", "CSS", "JavaScript", "JSON", "comment", "blank", "total"
"c:\Users\mrtan\Desktop\Code\html\software-engineer\scholarship-wepapp\client\src\contents\Announcement.css", "CSS", 43, 0, 0, 84, -12, 115
"c:\Users\mrtan\Desktop\Code\html\software-engineer\scholarship-wepapp\client\src\contents\Announcement.js", "JavaScript", 0, 39, 0, -1, -14, 24
"c:\Users\mrtan\Desktop\Code\html\software-engineer\scholarship-wepapp\client\src\contents\AnnouncementLogin.css", "CSS", 0, 0, 0, 4, -2, 2
"c:\Users\mrtan\Desktop\Code\html\software-engineer\scholarship-wepapp\client\src\contents\Interview.css", "CSS", 1, 0, 0, 4, -3, 2
"c:\Users\mrtan\Desktop\Code\html\software-engineer\scholarship-wepapp\client\src\contents\Interview.js", "JavaScript", 0, 0, 0, 0, -2, -2
"c:\Users\mrtan\Desktop\Code\html\software-engineer\scholarship-wepapp\client\src\contents\Profile.css", "CSS", -1, 0, 0, 7, -1, 5
"c:\Users\mrtan\Desktop\Code\html\software-engineer\scholarship-wepapp\client\src\contents\Profile.js", "JavaScript", 0, 0, 0, 0, 1, 1
"c:\Users\mrtan\Desktop\Code\html\software-engineer\scholarship-wepapp\client\src\contents\Report.css", "CSS", 50, 0, 0, 5, -3, 52
"c:\Users\mrtan\Desktop\Code\html\software-engineer\scholarship-wepapp\client\src\contents\Report.js", "JavaScript", 0, 5, 0, 0, 0, 5
"c:\Users\mrtan\Desktop\Code\html\software-engineer\scholarship-wepapp\client\src\contents\RoleSetting.js", "JavaScript", 0, 19, 0, 0, 9, 28
"c:\Users\mrtan\Desktop\Code\html\software-engineer\scholarship-wepapp\client\src\contents\Rolesetting.css", "CSS", 39, 0, 0, 7, 1, 47
"c:\Users\mrtan\Desktop\Code\html\software-engineer\scholarship-wepapp\client\src\contents\SchlorshipList.css", "CSS", -8, 0, 0, 6, -2, -4
"c:\Users\mrtan\Desktop\Code\html\software-engineer\scholarship-wepapp\client\src\contents\ScholarshipCheck.css", "CSS", 146, 0, 0, 9, 24, 179
"c:\Users\mrtan\Desktop\Code\html\software-engineer\scholarship-wepapp\client\src\contents\ScholarshipCheck.js", "JavaScript", 0, 5, 0, 0, -3, 2
"c:\Users\mrtan\Desktop\Code\html\software-engineer\scholarship-wepapp\client\src\contents\ScholarshipList.js", "JavaScript", 0, 6, 0, 1, 9, 16
"c:\Users\mrtan\Desktop\Code\html\software-engineer\scholarship-wepapp\client\src\contents\ScholarshipStatus.css", "CSS", 0, 0, 0, 4, 0, 4
"c:\Users\mrtan\Desktop\Code\html\software-engineer\scholarship-wepapp\client\src\data\scholarship-form\lo23j4g5v3.json", "JSON", 0, 0, -14, 0, -1, -15
"c:\Users\mrtan\Desktop\Code\html\software-engineer\scholarship-wepapp\client\src\modal\ConfirmModal.css", "CSS", 27, 0, 0, 0, 6, 33
"c:\Users\mrtan\Desktop\Code\html\software-engineer\scholarship-wepapp\client\src\modal\ConfirmModal.js", "JavaScript", 0, -10, 0, 10, -4, -4
"c:\Users\mrtan\Desktop\Code\html\software-engineer\scholarship-wepapp\client\src\modal\ImageModal.css", "CSS", 36, 0, 0, 0, 5, 41
"c:\Users\mrtan\Desktop\Code\html\software-engineer\scholarship-wepapp\client\src\modal\ImageModal.js", "JavaScript", 0, 26, 0, 0, 2, 28
"c:\Users\mrtan\Desktop\Code\html\software-engineer\scholarship-wepapp\client\src\pages\LoginPage.js", "JavaScript", 0, -16, 0, 0, -1, -17
"c:\Users\mrtan\Desktop\Code\html\software-engineer\scholarship-wepapp\client\src\pages\MainPage.css", "CSS", 6, 0, 0, 3, 7, 16
"c:\Users\mrtan\Desktop\Code\html\software-engineer\scholarship-wepapp\client\src\pages\MainPage.js", "JavaScript", 0, 4, 0, 0, 2, 6
"c:\Users\mrtan\Desktop\Code\html\software-engineer\scholarship-wepapp\client\src\services\firebase.js", "JavaScript", 0, -17, 0, -4, -7, -28
"c:\Users\mrtan\Desktop\Code\html\software-engineer\scholarship-wepapp\client\src\sub-contents\AnnouncementCreate.css", "CSS", 12, 0, 0, 4, -5, 11
"c:\Users\mrtan\Desktop\Code\html\software-engineer\scholarship-wepapp\client\src\sub-contents\AnnouncementCreate.js", "JavaScript", 0, 88, 0, -4, -2, 82
"c:\Users\mrtan\Desktop\Code\html\software-engineer\scholarship-wepapp\client\src\sub-contents\AnnouncementEdit.js", "JavaScript", 0, 78, 0, 3, 10, 91
"c:\Users\mrtan\Desktop\Code\html\software-engineer\scholarship-wepapp\client\src\sub-contents\InterviewRate.css", "CSS", 79, 0, 0, 5, 14, 98
"c:\Users\mrtan\Desktop\Code\html\software-engineer\scholarship-wepapp\client\src\sub-contents\InterviewRate.js", "JavaScript", 0, 58, 0, 0, 7, 65
"c:\Users\mrtan\Desktop\Code\html\software-engineer\scholarship-wepapp\client\src\sub-contents\InterviewSchedule.css", "CSS", 65, 0, 0, 3, 9, 77
"c:\Users\mrtan\Desktop\Code\html\software-engineer\scholarship-wepapp\client\src\sub-contents\InterviewSchedule.js", "JavaScript", 0, 40, 0, 0, 4, 44
"c:\Users\mrtan\Desktop\Code\html\software-engineer\scholarship-wepapp\client\src\sub-contents\ProfileCheck.css", "CSS", 88, 0, 0, 33, 7, 128
"c:\Users\mrtan\Desktop\Code\html\software-engineer\scholarship-wepapp\client\src\sub-contents\ProfileCheck.js", "JavaScript", 0, -5, 0, 0, 2, -3
"c:\Users\mrtan\Desktop\Code\html\software-engineer\scholarship-wepapp\client\src\sub-contents\ProfileEdit.css", "CSS", 26, 0, 0, 3, 9, 38
"c:\Users\mrtan\Desktop\Code\html\software-engineer\scholarship-wepapp\client\src\sub-contents\ProfileEdit.js", "JavaScript", 0, 33, 0, 0, 2, 35
"c:\Users\mrtan\Desktop\Code\html\software-engineer\scholarship-wepapp\client\src\sub-contents\ReportInspect.css", "CSS", 36, 0, 0, 3, 0, 39
"c:\Users\mrtan\Desktop\Code\html\software-engineer\scholarship-wepapp\client\src\sub-contents\ReportInspect.js", "JavaScript", 0, 63, 0, 0, 4, 67
"c:\Users\mrtan\Desktop\Code\html\software-engineer\scholarship-wepapp\client\src\sub-contents\ScholarshipCheckForm.css", "CSS", 152, 0, 0, 8, 15, 175
"c:\Users\mrtan\Desktop\Code\html\software-engineer\scholarship-wepapp\client\src\sub-contents\ScholarshipCheckForm.js", "JavaScript", 0, 248, 0, 0, 13, 261
"c:\Users\mrtan\Desktop\Code\html\software-engineer\scholarship-wepapp\client\src\sub-contents\ScholarshipListCreate.css", "CSS", -6, 0, 0, 5, -1, -2
"c:\Users\mrtan\Desktop\Code\html\software-engineer\scholarship-wepapp\client\src\sub-contents\ScholarshipListCreate.js", "JavaScript", 0, 67, 0, 0, 3, 70
"c:\Users\mrtan\Desktop\Code\html\software-engineer\scholarship-wepapp\client\src\sub-contents\ScholarshipListRegister.css", "CSS", 34, 0, 0, 4, 7, 45
"c:\Users\mrtan\Desktop\Code\html\software-engineer\scholarship-wepapp\client\src\sub-contents\ScholarshipListRegister.js", "JavaScript", 0, 166, 0, 0, 2, 168
"c:\Users\mrtan\Desktop\Code\html\software-engineer\scholarship-wepapp\client\src\sub-contents\ScholarshipListRegister2.css", "CSS", 80, 0, 0, 6, 6, 92
"c:\Users\mrtan\Desktop\Code\html\software-engineer\scholarship-wepapp\client\src\sub-contents\ScholarshipListRegister2.js", "JavaScript", 0, 76, 0, 0, 6, 82
"c:\Users\mrtan\Desktop\Code\html\software-engineer\scholarship-wepapp\client\src\sub-contents\test.css", "CSS", 30, 0, 0, 0, 3, 33
"Total", "-", 935, 973, -14, 212, 126, 2232