"filename", "language", "CSS", "JavaScript", "comment", "blank", "total"
"c:\Users\mrtan\Desktop\Code\html\software-engineer\scholarship-wepapp\client\src\App.css", "CSS", 33, 0, 0, 6, 39
"c:\Users\mrtan\Desktop\Code\html\software-engineer\scholarship-wepapp\client\src\App.js", "JavaScript", 0, 16, 0, 5, 21
"c:\Users\mrtan\Desktop\Code\html\software-engineer\scholarship-wepapp\client\src\components\Login.css", "CSS", 23, 0, 28, 5, 56
"c:\Users\mrtan\Desktop\Code\html\software-engineer\scholarship-wepapp\client\src\components\Login.js", "JavaScript", 0, 85, 2, 15, 102
"c:\Users\mrtan\Desktop\Code\html\software-engineer\scholarship-wepapp\client\src\contents\Announcement.css", "CSS", 162, 0, 92, 9, 263
"c:\Users\mrtan\Desktop\Code\html\software-engineer\scholarship-wepapp\client\src\contents\Announcement.js", "JavaScript", 0, 136, 4, 16, 156
"c:\Users\mrtan\Desktop\Code\html\software-engineer\scholarship-wepapp\client\src\contents\AnnouncementLogin.css", "CSS", 74, 0, 10, 5, 89
"c:\Users\mrtan\Desktop\Code\html\software-engineer\scholarship-wepapp\client\src\contents\AnnouncementLogin.js", "JavaScript", 0, 58, 0, 13, 71
"c:\Users\mrtan\Desktop\Code\html\software-engineer\scholarship-wepapp\client\src\contents\Interview.css", "CSS", 157, 0, 7, 19, 183
"c:\Users\mrtan\Desktop\Code\html\software-engineer\scholarship-wepapp\client\src\contents\Interview.js", "JavaScript", 0, 83, 0, 18, 101
"c:\Users\mrtan\Desktop\Code\html\software-engineer\scholarship-wepapp\client\src\contents\Profile.css", "CSS", 105, 0, 35, 16, 156
"c:\Users\mrtan\Desktop\Code\html\software-engineer\scholarship-wepapp\client\src\contents\Profile.js", "JavaScript", 0, 64, 0, 10, 74
"c:\Users\mrtan\Desktop\Code\html\software-engineer\scholarship-wepapp\client\src\contents\Report.css", "CSS", 113, 0, 7, 4, 124
"c:\Users\mrtan\Desktop\Code\html\software-engineer\scholarship-wepapp\client\src\contents\Report.js", "JavaScript", 0, 86, 0, 16, 102
"c:\Users\mrtan\Desktop\Code\html\software-engineer\scholarship-wepapp\client\src\contents\RoleSetting.js", "JavaScript", 0, 72, 0, 15, 87
"c:\Users\mrtan\Desktop\Code\html\software-engineer\scholarship-wepapp\client\src\contents\Rolesetting.css", "CSS", 103, 0, 7, 5, 115
"c:\Users\mrtan\Desktop\Code\html\software-engineer\scholarship-wepapp\client\src\contents\SchlorshipList.css", "CSS", 112, 0, 7, 11, 130
"c:\Users\mrtan\Desktop\Code\html\software-engineer\scholarship-wepapp\client\src\contents\ScholarshipCheck.css", "CSS", 155, 0, 9, 24, 188
"c:\Users\mrtan\Desktop\Code\html\software-engineer\scholarship-wepapp\client\src\contents\ScholarshipCheck.js", "JavaScript", 0, 85, 0, 17, 102
"c:\Users\mrtan\Desktop\Code\html\software-engineer\scholarship-wepapp\client\src\contents\ScholarshipList.js", "JavaScript", 0, 88, 1, 26, 115
"c:\Users\mrtan\Desktop\Code\html\software-engineer\scholarship-wepapp\client\src\contents\ScholarshipStatus.css", "CSS", 79, 0, 4, 4, 87
"c:\Users\mrtan\Desktop\Code\html\software-engineer\scholarship-wepapp\client\src\contents\ScholarshipStatus.js", "JavaScript", 0, 69, 0, 12, 81
"c:\Users\mrtan\Desktop\Code\html\software-engineer\scholarship-wepapp\client\src\data\datanews.js", "JavaScript", 0, 24, 0, 3, 27
"c:\Users\mrtan\Desktop\Code\html\software-engineer\scholarship-wepapp\client\src\index.css", "CSS", 12, 0, 0, 2, 14
"c:\Users\mrtan\Desktop\Code\html\software-engineer\scholarship-wepapp\client\src\index.js", "JavaScript", 0, 13, 3, 6, 22
"c:\Users\mrtan\Desktop\Code\html\software-engineer\scholarship-wepapp\client\src\modal\AlertModal.css", "CSS", 16, 0, 0, 1, 17
"c:\Users\mrtan\Desktop\Code\html\software-engineer\scholarship-wepapp\client\src\modal\AlertModal.js", "JavaScript", 0, 19, 0, 4, 23
"c:\Users\mrtan\Desktop\Code\html\software-engineer\scholarship-wepapp\client\src\modal\ConfirmModal.css", "CSS", 43, 0, 0, 6, 49
"c:\Users\mrtan\Desktop\Code\html\software-engineer\scholarship-wepapp\client\src\modal\ConfirmModal.js", "JavaScript", 0, 20, 11, 3, 34
"c:\Users\mrtan\Desktop\Code\html\software-engineer\scholarship-wepapp\client\src\modal\ImageModal.css", "CSS", 36, 0, 0, 5, 41
"c:\Users\mrtan\Desktop\Code\html\software-engineer\scholarship-wepapp\client\src\modal\ImageModal.js", "JavaScript", 0, 26, 0, 2, 28
"c:\Users\mrtan\Desktop\Code\html\software-engineer\scholarship-wepapp\client\src\pages\LoginPage.css", "CSS", 62, 0, 5, 1, 68
"c:\Users\mrtan\Desktop\Code\html\software-engineer\scholarship-wepapp\client\src\pages\LoginPage.js", "JavaScript", 0, 49, 1, 17, 67
"c:\Users\mrtan\Desktop\Code\html\software-engineer\scholarship-wepapp\client\src\pages\MainPage.css", "CSS", 175, 0, 11, 20, 206
"c:\Users\mrtan\Desktop\Code\html\software-engineer\scholarship-wepapp\client\src\pages\MainPage.js", "JavaScript", 0, 419, 20, 42, 481
"c:\Users\mrtan\Desktop\Code\html\software-engineer\scholarship-wepapp\client\src\reportWebVitals.js", "JavaScript", 0, 12, 0, 2, 14
"c:\Users\mrtan\Desktop\Code\html\software-engineer\scholarship-wepapp\client\src\sub-contents\AnnouncementCreate.css", "CSS", 142, 0, 13, 29, 184
"c:\Users\mrtan\Desktop\Code\html\software-engineer\scholarship-wepapp\client\src\sub-contents\AnnouncementCreate.js", "JavaScript", 0, 148, 1, 19, 168
"c:\Users\mrtan\Desktop\Code\html\software-engineer\scholarship-wepapp\client\src\sub-contents\AnnouncementEdit.css", "CSS", 0, 0, 0, 1, 1
"c:\Users\mrtan\Desktop\Code\html\software-engineer\scholarship-wepapp\client\src\sub-contents\AnnouncementEdit.js", "JavaScript", 0, 84, 3, 14, 101
"c:\Users\mrtan\Desktop\Code\html\software-engineer\scholarship-wepapp\client\src\sub-contents\InterviewRate.css", "CSS", 79, 0, 5, 15, 99
"c:\Users\mrtan\Desktop\Code\html\software-engineer\scholarship-wepapp\client\src\sub-contents\InterviewRate.js", "JavaScript", 0, 69, 0, 10, 79
"c:\Users\mrtan\Desktop\Code\html\software-engineer\scholarship-wepapp\client\src\sub-contents\InterviewSchedule.css", "CSS", 65, 0, 3, 10, 78
"c:\Users\mrtan\Desktop\Code\html\software-engineer\scholarship-wepapp\client\src\sub-contents\InterviewSchedule.js", "JavaScript", 0, 46, 0, 7, 53
"c:\Users\mrtan\Desktop\Code\html\software-engineer\scholarship-wepapp\client\src\sub-contents\InterviewScheduleCreate.css", "CSS", 0, 0, 0, 1, 1
"c:\Users\mrtan\Desktop\Code\html\software-engineer\scholarship-wepapp\client\src\sub-contents\InterviewScheduleCreate.js", "JavaScript", 0, 6, 0, 4, 10
"c:\Users\mrtan\Desktop\Code\html\software-engineer\scholarship-wepapp\client\src\sub-contents\InterviewScheduleEdit.css", "CSS", 0, 0, 0, 1, 1
"c:\Users\mrtan\Desktop\Code\html\software-engineer\scholarship-wepapp\client\src\sub-contents\InterviewScheduleEdit.js", "JavaScript", 0, 6, 0, 4, 10
"c:\Users\mrtan\Desktop\Code\html\software-engineer\scholarship-wepapp\client\src\sub-contents\ProfileCheck.css", "CSS", 88, 0, 33, 8, 129
"c:\Users\mrtan\Desktop\Code\html\software-engineer\scholarship-wepapp\client\src\sub-contents\ProfileCheck.js", "JavaScript", 0, 59, 0, 12, 71
"c:\Users\mrtan\Desktop\Code\html\software-engineer\scholarship-wepapp\client\src\sub-contents\ProfileEdit.css", "CSS", 106, 0, 5, 22, 133
"c:\Users\mrtan\Desktop\Code\html\software-engineer\scholarship-wepapp\client\src\sub-contents\ProfileEdit.js", "JavaScript", 0, 181, 0, 14, 195
"c:\Users\mrtan\Desktop\Code\html\software-engineer\scholarship-wepapp\client\src\sub-contents\ReportInspect.css", "CSS", 36, 0, 3, 1, 40
"c:\Users\mrtan\Desktop\Code\html\software-engineer\scholarship-wepapp\client\src\sub-contents\ReportInspect.js", "JavaScript", 0, 69, 0, 8, 77
"c:\Users\mrtan\Desktop\Code\html\software-engineer\scholarship-wepapp\client\src\sub-contents\ScholarshipCheckForm.css", "CSS", 152, 0, 8, 16, 176
"c:\Users\mrtan\Desktop\Code\html\software-engineer\scholarship-wepapp\client\src\sub-contents\ScholarshipCheckForm.js", "JavaScript", 0, 254, 0, 16, 270
"c:\Users\mrtan\Desktop\Code\html\software-engineer\scholarship-wepapp\client\src\sub-contents\ScholarshipEdit.css", "CSS", 0, 0, 0, 1, 1
"c:\Users\mrtan\Desktop\Code\html\software-engineer\scholarship-wepapp\client\src\sub-contents\ScholarshipEdit.js", "JavaScript", 0, 6, 0, 4, 10
"c:\Users\mrtan\Desktop\Code\html\software-engineer\scholarship-wepapp\client\src\sub-contents\ScholarshipListCreate.css", "CSS", 133, 0, 14, 34, 181
"c:\Users\mrtan\Desktop\Code\html\software-engineer\scholarship-wepapp\client\src\sub-contents\ScholarshipListCreate.js", "JavaScript", 0, 146, 5, 32, 183
"c:\Users\mrtan\Desktop\Code\html\software-engineer\scholarship-wepapp\client\src\sub-contents\ScholarshipListEdit.css", "CSS", 0, 0, 0, 1, 1
"c:\Users\mrtan\Desktop\Code\html\software-engineer\scholarship-wepapp\client\src\sub-contents\ScholarshipListEdit.js", "JavaScript", 0, 6, 0, 4, 10
"c:\Users\mrtan\Desktop\Code\html\software-engineer\scholarship-wepapp\client\src\sub-contents\ScholarshipListRegister.css", "CSS", 114, 0, 6, 13, 133
"c:\Users\mrtan\Desktop\Code\html\software-engineer\scholarship-wepapp\client\src\sub-contents\ScholarshipListRegister.js", "JavaScript", 0, 241, 0, 12, 253
"c:\Users\mrtan\Desktop\Code\html\software-engineer\scholarship-wepapp\client\src\sub-contents\ScholarshipListRegister2.css", "CSS", 80, 0, 6, 6, 92
"c:\Users\mrtan\Desktop\Code\html\software-engineer\scholarship-wepapp\client\src\sub-contents\ScholarshipListRegister2.js", "JavaScript", 0, 76, 0, 6, 82
"c:\Users\mrtan\Desktop\Code\html\software-engineer\scholarship-wepapp\client\src\sub-contents\test.css", "CSS", 30, 0, 0, 3, 33
"Total", "-", 2485, 2821, 369, 713, 6388